11111111222222222111111111111111111
11221122222222222222222222222222221
11221122222222222222222222222222221
11111111222222222111111111111111111
11221122222222222222222222222222221
11221122222222222222222222222222221
11111111222222222111111111111111111
11221122222222222222222222222222221
11221122222222222222222222222222221
11221122222222222222222222222222221
11221122222222222222222222222222221
---
0000000000000000000000000000000000
0333333333333333333333333333333333
03                               3
03     3               33333333333
03     3                         3
03     3                         3
03     3           333333333333333
03  p  3                         3
03     3                         3
0333333333333333333333333333333333
---
0000000000000000000000000000000000
0333333333333333333333333333333333
03                               3
03     3               33333333333
03     3                         3
03     3                         3
03     3           333333333333333
03     3                         3
03     3                         3
0333333333333333333333333333333333
---
0000000000000000000000000000000000
0333333333333333330033333333333333
03                               3
03                               3
03                               0
03                               0
03                               3
03                               3
03                               3
0333333333333333330033333333333333
---
0000000000000000000000000000000000
0333333333333333330033333333333333
03                               3
03                               3
03                               0
03                               0
03                               3
03                               3
03                               3
0333333333333333330033333333333333
---
0000000000000000000000000000000000
0333333333333333330033333333333333
03                               3
03                               3
03                               0
03                               0
03                               3
03                               3
03                               3
0333333333333333330033333333333333
---
44444444444444444444444444444444444
44444444444444444444444444444444444
44444444444444444444444444444444444
44444444444444444444444444444444444
44444444444444444444444444444444444
44444444444444444444444444444444444
44444444444444444444444444444444444
44444444444444444444444444444444444
44444444444444444444444444444444444
44444444444444444444444444444444444
44444444444444444444444444444444444