2222222222222211112211111111222222211221222222
2221111221111112222122221222221112222222222111
2222122222222211221211111122111222222111222222
2211211121111222112221112211222111211221122111
2222211112222111221111221122112111122112222222
2221112212111111211111111121121122121121122111
2211111221121122112112222211222112211222222121
2222122112111221222222222122211221122212222111
2221222222222211222211111122211222222211122222
2221222222211111222112221122222222222222222211
2121221112222111222111121122222211122222221222
---
0000000000000000000000000000000000
0333333333333333333333333333333333333333333333
03
03
03      3
03      3
03      3
03  p   3
03      3
0333333333333333333333333333333333333333333333
---